15,10
###############
#    #   #    #
# ## # # # ## #
#      #      #
# # ## # ## # #
# # #     # # #
#      #      # 
# ## # # # ## #
#    #   #    #
###############

